17,17,17,17,17,17,17,17,17,17
17,0,0,17,17,16,0,4,0,17
17,0,22,17,17,16,0,0,0,17
17,0,0,0,0,16,16,16,17,17
17,0,0,0,0,0,0,0,17,17
17,0,9,0,19,0,0,3,0,17
17,0,0,0,0,0,0,0,0,17
17,17,17,17,17,17,17,17,17,17