17,17,17,17,17,17,17,17
17,0,0,0,0,0,0,17
17,0,6,0,0,0,8,17
17,0,0,0,0,0,0,17
17,0,0,0,0,0,17,17
17,0,0,0,0,19,0,17
17,3,0,0,0,0,23,17
17,17,17,17,17,17,17,17