0,0,0,17,17,17,17,17,,0,0,0
0,0,0,17,0,0,19,17,0,0,0,0
0,0,17,17,6,0,22,17,0,0
0,17,17,0,0,0,0,17,0,0
0,17,0,0,0,0,0,17,17,17,17
0,17,0,0,16,16,11,16,16,8,17
0,17,0,16,17,17,17,17,17,17,17
0,17,0,0,0,0,17,,,,,
0,17,0,0,1,0,17,,,,,
0,17,17,17,0,0,17,,,,,
0,0,0,17,17,17,17,,,,,