0,17,17,17,17,17,17,17,17,17,0
17,17,0,0,0,17,0,0,0,17,0
17,0,22,0,0,17,0,9,0,17,0
17,0,0,0,0,17,17,17,0,17,17
17,0,0,0,2,0,16,16,0,12,17
17,0,3,19,0,0,0,0,0,16,17
17,17,0,0,17,0,0,0,0,0,17
0,17,17,17,17,17,17,17,17,17,17