0,17,17,17,17,0,0,0,0,0
17,17,22,0,17,0,0,0,0,0
17,0,0,0,17,17,17,17,17,17
17,0,0,0,17,17,0,0,0,17
17,0,0,19,0,17,0,8,0,17
17,0,0,0,0,17,17,0,0,17
17,0,0,3,0,17,0,0,0,17
17,0,0,0,0,0,0,0,0,17
17,17,17,17,17,17,17,17,17,17