17,17,17,17,17,17,17,0,0
17,22,0,4,0,0,17,0,0
17,0,0,0,0,0,17,0,0
17,0,0,0,0,0,17,17,0
17,0,0,0,0,0,0,17,0
17,0,0,0,19,0,0,17,0
17,0,0,0,0,0,0,17,17
17,3,0,0,0,0,0,0,17
17,17,0,0,11,0,8,0,17
0,17,0,0,0,0,0,0,17
0,17,17,17,17,17,17,17,17