0,0,0,0,17,17,17,17,0,0
0,0,0,0,17,22,0,17,0,0
17,17,17,17,17,0,0,17,17,17
17,0,0,0,0,0,0,0,0,17
17,0,0,3,0,13,17,8,0,17
17,2,0,0,0,0,0,0,0,17
17,0,0,19,0,0,0,0,0,17
17,17,17,17,17,17,17,17,17,17
