17,17,17,17,17,17,0,0,0,0
17,0,0,19,0,17,0,0,0,0
17,2,0,0,0,17,17,17,17,17
17,0,0,0,0,17,0,0,0,17
17,0,0,17,17,17,0,0,0,17
17,0,0,16,0,0,0,12,0,17
17,17,0,17,16,0,17,0,0,17
0,17,0,0,0,0,17,17,17,17
0,17,0,0,20,0,17,0,0,0
0,17,17,17,17,17,17,0,0,0