17,17,17,17,17,17,17,17,17
17,0,0,0,0,0,0,0,17
17,0,0,0,0,0,0,0,17
17,0,0,0,0,0,12,0,17
17,21,16,16,16,0,17,17,17
17,0,19,3,0,0,0,17,0
17,0,0,0,0,0,8,17,0
17,17,17,17,17,17,17,17,0