0,17,17,17,17,17,0,17,17,17,17
0,17,19,0,0,17,17,17,0,0,17
0,17,0,9,6,0,0,0,0,22,17
0,17,0,0,0,17,17,17,0,0,17
17,17,0,16,16,16,16,16,16,0,17
17,0,0,0,0,0,0,0,0,0,17
17,0,0,0,0,17,17,17,0,0,17
17,17,1,0,0,17,0,17,0,0,17
17,17,17,17,17,17,0,17,17,17,17